0 15 25
2 2 2 2 2 2 2 2 2 2 2 2 2 2 2 2 2 2 2 2 2 2 2 2 2
2 9 9 9 9 9 9 9 9 9 9 9 9 9 9 9 9 9 9 9 9 9 9 9 2
2 0 2 2 2 0 0 0 0 0 2 2 2 6 0 0 0 0 2 2 2 7 2 0 2
2 0 2 9 9 0 0 0 0 0 9 9 9 0 0 0 0 0 9 9 2 0 9 0 2
2 0 2 0 0 0 0 0 0 0 0 0 2 0 2 0 2 0 0 9 2 0 2 0 2
2 0 9 0 0 0 6 0 0 0 0 0 9 0 9 0 9 0 0 0 9 0 9 0 2
2 0 0 0 0 0 0 0 0 0 2 2 2 0 0 0 0 0 2 0 2 0 2 0 2
2 0 9 0 0 0 0 0 0 0 9 9 9 0 0 0 0 0 9 0 9 0 9 0 2
2 0 2 0 2 0 2 0 0 0 0 0 0 0 2 0 2 0 2 0 2 0 2 0 2
2 0 9 0 9 0 9 0 0 0 0 0 0 0 9 0 9 0 9 0 9 0 9 0 2
2 0 2 8 0 0 2 0 0 0 0 0 0 0 2 0 2 0 0 0 2 0 2 0 2
2 0 2 0 0 0 9 0 0 0 0 0 0 0 9 0 9 0 0 0 2 0 9 0 2
2 0 2 2 2 0 2 0 2 0 2 0 2 0 2 0 2 7 2 2 2 0 2 0 2
2 0 9 9 9 0 9 0 9 0 9 0 9 0 9 0 9 0 9 9 9 0 9 0 2
2 2 2 2 2 2 2 2 2 2 2 2 2 2 2 2 2 2 2 2 2 2 2 2 2