2 15 25
2 2 2 2 2 2 2 2 2 2 2 2 2 2 2 2 2 2 2 2 2 2 2 2 2
2 9 9 3 9 9 9 9 9 3 9 9 9 9 9 9 9 9 3 9 9 9 9 9 2
2 0 2 0 2 0 2 0 2 0 2 0 2 3 2 0 2 0 2 0 2 0 2 0 2
2 0 9 0 9 0 9 0 9 0 9 0 3 3 9 0 3 0 9 0 9 0 9 0 2
2 0 2 0 2 0 2 0 2 0 2 0 2 0 2 0 2 0 2 0 2 0 2 0 2
2 0 9 8 9 0 9 0 9 0 9 0 9 0 9 0 9 0 9 0 9 0 9 0 2
2 0 2 0 2 0 2 0 2 3 2 0 2 0 2 0 2 0 2 0 2 0 2 0 2
2 0 9 0 3 0 9 0 9 0 9 0 9 3 9 0 9 0 9 3 9 0 9 0 2
2 0 2 0 2 3 2 0 2 0 2 0 2 0 2 0 2 3 2 0 2 0 2 0 2
2 0 9 0 0 7 9 0 9 0 9 3 3 3 9 0 9 0 9 0 9 0 9 0 2
2 0 2 0 2 0 2 0 2 0 2 0 2 0 2 0 2 0 2 0 2 0 2 0 2
2 0 9 0 9 0 9 0 9 0 9 6 9 0 9 0 3 0 9 3 9 0 9 0 2
2 0 2 0 2 0 2 0 2 0 2 0 2 0 2 0 2 0 2 0 2 0 2 0 2
2 0 9 0 9 0 9 0 9 0 9 0 9 0 9 0 9 0 9 0 9 0 9 0 2
2 2 2 2 2 2 2 2 2 2 2 2 2 2 2 2 2 2 2 2 2 2 2 2 2