0 15 25
11 12 12 12 12 12 12 12 12 12 12 12 12 12 12 12 12 12 12 12 12 12 12 12 13
14 9 9 9 9 9 9 9 9 9 9 9 9 9 9 9 9 9 9 9 9 9 9 9 15
14 0 2 2 2 0 0 0 0 0 2 2 2 6 0 0 0 0 2 2 2 7 2 0 15
14 0 2 9 9 0 0 0 0 0 9 9 9 0 0 0 0 0 9 9 2 0 9 0 15
14 0 2 0 0 0 0 0 0 0 0 0 2 0 2 0 2 0 0 9 2 0 2 0 15
14 0 9 0 0 0 6 0 0 0 0 0 9 0 9 0 9 0 0 0 9 0 9 0 15
14 0 0 0 0 0 0 0 0 0 2 2 2 0 0 0 0 0 2 0 2 0 2 0 15
14 0 0 0 0 0 0 0 0 0 9 9 9 0 0 0 0 0 9 0 9 0 9 0 15
14 0 2 0 2 0 2 0 0 0 0 0 0 0 2 0 2 0 2 0 2 0 2 0 15
14 0 9 0 9 0 9 0 0 0 0 0 0 0 9 0 9 0 9 0 9 0 9 0 15
14 0 2 8 0 0 2 0 0 0 0 0 0 0 2 0 2 0 0 0 2 0 2 0 15
14 0 2 0 0 0 9 0 0 0 0 0 0 0 9 0 9 0 0 0 2 0 9 0 15
14 0 2 2 2 0 2 0 2 0 2 0 2 0 2 0 2 7 2 2 2 0 2 0 15
14 0 9 9 9 0 9 0 9 0 9 0 9 0 9 0 9 0 9 9 9 0 9 0 15
16 17 17 17 17 17 17 17 17 17 17 17 17 17 17 17 17 17 17 17 17 17 17 17 18