2 15 25
2 2 2 2 2 2 2 2 2 2 2 2 2 2 2 2 2 2 2 2 2 2 2 2 2
2 0 0 3 7 0 0 0 0 0 0 0 0 0 0 0 0 0 0 0 0 0 0 0 2
2 0 2 3 2 0 2 0 2 0 2 0 2 0 2 0 2 0 2 0 2 0 2 0 2
2 3 3 3 3 0 9 0 9 0 9 0 9 0 9 0 9 0 9 0 9 0 9 0 2
2 7 2 3 2 6 2 0 2 0 2 0 2 3 2 0 2 0 2 0 2 0 2 0 2
2 0 9 0 9 0 9 0 9 0 9 0 9 0 9 0 9 0 9 0 9 0 9 0 2
2 0 2 0 2 0 2 0 2 0 2 0 2 0 2 0 2 0 2 0 2 0 2 0 2
2 0 9 0 9 0 3 3 9 0 9 0 9 0 9 0 9 0 9 0 9 0 9 0 2
2 0 2 0 2 0 2 3 2 0 2 0 2 0 2 0 2 0 2 0 2 0 2 0 2
2 0 9 0 9 0 9 0 9 0 9 0 9 0 9 0 9 0 9 0 9 0 9 0 2
2 0 2 3 2 0 2 0 2 0 2 0 2 0 2 0 2 0 2 0 2 3 2 3 2
2 0 9 3 3 0 9 0 9 0 9 0 9 0 9 0 9 6 9 0 3 7 3 3 2
2 0 2 0 2 0 2 0 2 0 2 0 2 0 2 0 2 0 2 0 2 3 2 0 2
2 0 9 0 9 0 9 0 9 0 9 0 9 0 9 0 9 0 9 0 7 3 9 0 2
2 2 2 2 2 2 2 2 2 2 2 2 2 2 2 2 2 2 2 2 2 2 2 2 2